{
  "tiles": [
    ["W", "W", "W", "W", "W", "W", "W", "W", "W", "W"],
    ["W", "W", "W", "P", "P", "P", "P", "W", "W", "W"],
    ["W", "W", "P", "P", "P", "P", "P", "P", "W", "W"],
    ["W", "P", "P", "P", "P", "P", "P", "P", "P", "W"],
    ["W", "P", "I", "P", "P", "P", "P", "P", "P", "W"],
    ["W", "P", "I", "P", "P", "P", "P", "P", "P", "W"],
    ["W", "P", "P", "P", "P", "P", "P", "P", "P", "W"],
    ["W", "W", "P", "P", "P", "P", "P", "P", "W", "W"],
    ["W", "W", "W", "P", "P", "P", "P", "W", "W", "W"],
    ["W", "W", "W", "W", "W", "W", "W", "W", "W", "W"]
  ],
  "actors": [
    {"type": "Player", "x": 4, "y": 4},
    {"type": "MovableBlock", "x": 5, "y": 5},
    {"type":  "Player", "x": 0, "y": 0}
  ]
}
