{
 "tiles": [
  ["P","P","P","P","P","P","P","P","P","P","P","P","P","P","P","P","P","P","P","P","P","P","P"],
  ["P","P","P","P","P","P","P","P","P","P","P","P","P","P","P","P","P","P","P","P","P","P","P"],
  ["P","P","P","P","P","P","P","P","P","P","P","P","P","P","P","P","P","P","P","P","P","P","P"],
  ["P","P","P","P","P","P","P","P","P","P","P","P","P","P","P","P","P","P","P","P","P","P","P"],
  ["P","P","P","P","P","P","P","P","P","P","P","P","P","P","P","P","P","P","P","P","P","P","P"],
  ["P","P","P","P","P","P","P","P","P","P","P","P","P","P","P","P","P","P","P","P","P","P","P"],
  ["P","P","P","P","P","P","P","P","P","P","P","P","P","P","P","P","P","P","P","P","P","P","P"],
  ["P","P","P","P","P","P","P","P","P","P","P","P","P","P","P","P","P","P","P","P","P","P","P"],
  ["P","P","P","P","P","G","G","G","G","G","G","G","P","P","P","P","P","P","P","P","P","P","P"],
  ["P","P","P","P","P","G","P","P","P","P","P","G","P","P","P","P","P","P","P","P","P","P","P"],
  ["P","P","P","P","P","G","P","G","G","G","P","G","P","P","P","P","P","P","P","P","P","P","P"],
  ["P","P","P","P","P","G","P","P","G","P","P","G","P","P","P","P","P","P","P","P","P","P","P"],
  ["P","P","P","P","P","G","P","P","P","P","P","G","P","P","P","P","P","P","P","P","P","P","P"],
  ["P","P","P","P","P","G","G","G","G","G","G","G","P","P","P","P","P","P","P","P","P","P","P"],
  ["P","P","P","P","P","P","P","P","P","P","P","P","P","P","P","P","P","P","P","P","P","P","P"],
  ["P","P","P","P","P","P","P","P","P","P","P","P","P","P","P","P","P","P","P","P","P","P","P"],
  ["P","P","P","P","P","P","P","P","P","P","P","P","P","P","P","P","P","P","P","P","P","P","P"],
  ["P","P","P","P","P","P","P","P","P","P","P","P","P","P","P","P","P","P","P","P","P","P","P"],
  ["P","P","P","P","P","P","P","P","P","P","P","P","P","P","P","P","P","P","P","P","P","P","P"],
  ["P","P","P","P","P","P","P","P","P","P","P","P","P","P","P","P","P","P","P","P","P","P","P"],
  ["P","P","P","P","P","P","P","P","P","P","P","P","P","P","P","P","P","P","P","P","P","P","P"],
  ["P","P","P","P","P","P","P","P","P","P","P","P","P","P","P","P","P","P","P","P","P","P","P"],
  ["P","P","P","P","P","P","P","P","P","P","P","P","P","P","P","P","P","P","P","P","P","P","P"],
  ["P","P","P","P","P","P","P","P","P","P","P","P","P","P","P","P","P","P","P","P","P","P","P"],
  ["P","P","P","P","P","P","P","P","P","P","P","P","P","P","P","P","P","P","P","P","P","P","P"],
  ["P","P","P","P","P","P","P","P","P","P","P","P","P","P","P","P","P","P","P","P","P","P","P"],
  ["P","P","P","P","P","P","P","P","P","P","P","P","P","P","P","P","P","P","P","P","P","P","P"],
  ["P","P","P","P","P","P","P","P","P","P","P","P","P","P","P","P","P","P","P","P","P","P","P"],
  ["P","P","P","P","P","P","P","P","P","P","P","P","P","P","P","P","P","P","P","P","P","P","P"],
  ["P","P","P","P","P","P","P","P","P","P","P","P","P","P","P","P","P","P","P","P","P","P","P"]
 ],
 "actors": [
  {"type": "Player", "x": 10, "y": 10},
  {"type": "Bug", "x": 10, "y": 10}
 ]
}
