{
  "tiles": [
    ["W", "W", "W", "W", "W", "W", "W", "W", "W", "W"],
    ["W", ".", ".", ".", ".", ".", ".", ".", ".", "W"],
    ["W", ".", "W", ".", "W", "W", ".", "W", ".", "W"],
    ["W", ".", ".", ".", ".", ".", ".", ".", ".", "W"],
    ["W", ".", "W", "W", "W", ".", "W", "W", ".", "W"],
    ["W", ".", ".", ".", ".", ".", ".", ".", ".", "W"],
    ["W", ".", "W", ".", "W", "W", ".", "W", ".", "W"],
    ["W", ".", ".", ".", ".", ".", ".", ".", ".", "W"],
    ["W", ".", ".", ".", ".", ".", ".", ".", ".", "W"],
    ["W", "W", "W", "W", "W", "W", "W", "W", "W", "W"],
    ["W", ".", ".", ".", ".", ".", ".", ".", ".", "W"],
    ["W", "W", "W", "W", "W", "W", "W", "W", "W", "W"],
    ["W", ".", ".", ".", ".", ".", ".", ".", ".", "W"],
    ["W", "W", "W", "W", "W", "W", "W", "W", "W", "W"],
    ["W", ".", ".", ".", ".", ".", ".", ".", ".", "W"],
    ["W", "W", "W", "W", "W", "W", "W", "W", "W", "W"],
    ["W", ".", ".", ".", ".", ".", ".", ".", ".", "W"],
    ["W", "W", "W", "W", "W", "W", "W", "W", "W", "W"]
  ],
  "actors": [
    {"type": "Player", "x": 2, "y": 2}
  ]
}
